{
    "levels": [
        {
            "width": 400,
            "height": 450,
            "row_num": 9,
            "col_num": 8,
            "row_pos": 2,
            "col_pos": 2,
            "target": [[2, 1], [3, 5], [4, 1], [5, 4],[6,3],[6, 6], [7, 4]],
            "grid": [
                [0,0,1,1,1,1,1,0],
                [1,1,1,0,0,0,1,0],
                [1,4,2,3,0,0,1,0],
                [1,1,1,0,3,4,1,0],
                [1,4,1,1,3,0,1,0],
                [1,0,1,0,4,0,1,1],
                [1,3,0,3,3,3,4,1],  
                [1,0,0,0,4,0,0,1],
                [1,1,1,1,1,1,1,1]
            ]
        },
        {
            "width": 1100,
            "height": 550,
            "row_num": 11,
            "col_num": 22,
            "row_pos": 8,
            "col_pos": 12,
            "target": [[6, 19], [6, 20], [7, 19], [7, 20], [8, 19], [8, 20]],
            "grid": [
                [0,0,0,0,1,1,1,1,1,0,0,0,0,0,0,0,0,0,0,0,0,0],
                [0,0,0,0,1,0,0,0,1,0,0,0,0,0,0,0,0,0,0,0,0,0],
                [0,0,0,0,1,3,0,0,1,0,0,0,0,0,0,0,0,0,0,0,0,0],
                [0,0,1,1,1,0,0,3,1,1,1,0,0,0,0,0,0,0,0,0,0,0],
                [0,0,1,0,0,3,0,0,3,0,1,0,0,0,0,0,0,0,0,0,0,0],
                [1,1,1,0,1,0,1,1,1,0,1,0,0,0,0,0,1,1,1,1,1,1],
                [1,0,0,0,1,0,1,1,1,0,1,1,1,1,1,1,1,0,0,4,4,1],
                [1,0,3,0,0,3,0,0,0,0,0,0,0,0,0,0,0,0,0,4,4,1],
                [1,1,1,1,1,0,1,1,1,1,0,1,2,1,1,1,1,0,0,4,4,1],
                [0,0,0,0,1,0,0,0,0,0,0,1,1,1,0,0,1,1,1,1,1,1],
                [0,0,0,0,1,1,1,1,1,1,1,1,0,0,0,0,0,0,0,0,0,0]
            ]
        }
    ]
}
